####*################
####.#.....#..#....##
###..###..#.....#..##
##........###.....###
#...@..#..#........##
###..#.......##.....#
#....###...##...#...#
##...##...##.......##
#....##....#....#..##
#####################