####*################
#.....#####........##
###.............#..##
##........#.#.....###
#...@..#....##.....##
#......##...###..##.#
#.#..###....###.....#
##..........##.....##
#.......##....#....##
#####################