####*################
#..................##
###.............#..##
##........###.....###
#...@..#######.....##
#......##...###.....#
#....###....###.....#
##.................##
#..................##
#####################