####*################
####...##############
###..###...##########
##........###########
#...@..#......#######
###..###..###.#######
#####################
#####################
#####################
#####################