####*################
####.#.##############
###..###..###########
##........######.####
#...@.....###########
###........##########
###....4....#########
#####################
#####################
#####################